adearmondsattler = adearmondsattler <adearmondsattler>
allen = allen <allen>
andrew = andrew <andrew>
andrewd = andrewd <andrewd>
bbyers = bbyers <bbyers>
cameron = cameron <cameron>
chris = chris <chris>
david = david <david>
dennis = dennis <dennis>
drtech = drtech <drtech>
dwkrueger = dwkrueger <dwkrueger>
fcarlier = fcarlier <fcarlier>
fdscadmin = fdscadmin <fdscadmin>
grahamde = grahamde <grahamde>
grahamtest = grahamtest <grahamtest>
joe = joe <joe>
jordansparks = jordansparks <jordansparks>
josh = josh <josh>
jsalmon = jsalmon <jsalmon>
Kapricorn = Kapricorn <Kapricorn>
KathieH = KathieH <KathieH>
kendras = kendras <kendras>
kmmca1 = kmmca1 <kmmca1>
lstoller = lstoller <lstoller>
lukem = lukem <lukem>
michael = michael <michael>
mlangley = mlangley <mlangley>
mowgli = mowgli <mowgli>
muirj = muirj <muirj>
rhouse = rhouse <rhouse>
ryan = ryan <ryan>
Ryan = Ryan <Ryan>
sam = sam <sam>
saul = saul <saul>
stevens = stevens <stevens>
tgriswold = tgriswold <tgriswold>
wjstarck = wjstarck <wjstarck>
